



RRRRRRRRRRR
RRRRRRRRRRR
OOOOOOOOOOO
OOOOOOOOOOO
GGGGGGGGGGG
GGGGGGGGGGG